border_size=1
usage=map

Rr          , Rr          , Rr          , Rr          , Rr          , Rr          , Rr          , Rr          , Rr          , Rr          , Rr          , Rr          , Rr          , Rr          , Rr          , Rr          , Rr          , Rr          , Rr          , Rr          , Rr          , Rr          , Rr          , Rr          , Rr          , Rr          , Rr          , Rr          , Rr          , Rr          , Rr          , Rr          , Rr          
Rr          , Rr          , Rr          , Rr          , Rr          , Rr          , Rr          , Rr          , Rr          , Rr          , Rr          , Rr          , Rr          , Rr          , Rr          , Rr          , Wo          , Rr          , Rr          , Rr          , Rr          , Rr          , Rr          , Rr          , Rr          , Rr          , Rr          , Rr          , Rr          , Rr          , Rr          , Rr          , Rr          
Rr          , Rr          , Rr          , Rr          , Rr          , Rr          , Rr          , Rr          , Rr          , Rr          , Rr          , Rr          , Rr          , Rr          , Wo          , Wo          , Ww          , Wo          , Wo          , Rr          , Rr          , Rr          , Rr          , Rr          , Rr          , Rr          , Rr          , Rr          , Rr          , Rr          , Rr          , Rr          , Rr          
Rr          , Rr          , Rr          , Rr          , Rr          , Rr          , Rr          , Rr          , Rr          , Rr          , Rr          , Rr          , Wo          , Wo          , Ww          , Ww          , Ke          , Ww          , Ww          , Wo          , Wo          , Rr          , Rr          , Rr          , Ch          , Rr          , Rr          , Rr          , Rr          , Rr          , Rr          , Rr          , Rr          
Rr          , Rr          , Rr          , Rr          , Rr          , Rr          , Rr          , Rr          , Rr          , Rr          , Wo          , Wo          , Ww          , Ww          , Gg          , Ke          , Dd^Vdt      , Ke          , Gg          , Ww          , Ww          , Wo          , Wo          , Ch          , Ch          , Ch          , Ch          , Rr          , Rr          , Rr          , Rr          , Rr          , Rr          
Rr          , Rr          , Rr          , Rr          , Rr          , Rr          , Rr          , Rr          , Wo          , Wo          , Ww          , Ww          , Gg          , Gg          , Ds          , Ke          , Ke          , Ke          , Ds          , Gg          , Gg          , Ww          , Ww          , Wo          , Wo          , Ch          , Ch          , Rr          , Rr          , Rr          , Rr          , Rr          , Rr          
Xu          , Rr          , Rr          , Rr          , Rr          , Rr          , Wo          , Wo          , Ww          , Ww          , Gg          , Gg          , Ds          , Ds          , Dd^Dr       , Ds          , Ds          , Ds          , Ds          , Ds          , Ds          , Gg          , Ww          , Ww          , Ww          , Wo          , Wo          , Rr          , Rr          , Rr          , Rr          , Rr          , Rr          
Ds          , Xu          , Xu          , Rr          , Rr          , Wo          , Ww          , Ww          , Gg          , Gg          , Gs^Ft       , Gs^Ft       , Ds          , Ds          , Ds          , Ds          , Ds          , Ds          , Gs^Ft       , Gs^Ft       , Ds          , Ds          , Ww^Bw\      , Ww          , Gg          , Ww          , Ww          , Wo          , Wo          , Rr          , Rr          , Rr          , Rr          
Ds          , Ds          , Ds          , Xu          , Xu          , Wo          , Gg          , Gg          , Ds          , Ds          , Ds          , Ds          , Ds          , Ds          , Ds          , Dd^Do       , Ds          , Ds          , Ds          , Gs^Ft       , Ds          , Ww          , Ww          , Ds          , Ds          , Gg          , Gg          , Ww          , Ww          , Wo          , Wo          , Rr          , Rr          
Ds          , Ds          , Ds          , Ds          , 2 Cud       , Xu          , Ds          , Ds          , Dd^Do       , Ds          , Ds          , Ds          , Hd          , Hd          , Ds          , Ds          , Ds          , Dd^Do       , Ds          , Ds          , Ww          , Ww          , Ds          , Ds          , Gs^Ft       , Gs^Ft       , Ds          , Gg          , Ke          , Ww          , Ww          , Wo          , Rr          
Xu          , Ds          , Ds          , Cud         , Cud         , Ds          , Ds          , Ds          , Ds          , Ds          , Ds          , Hd          , Ds          , Hd          , Ds          , Dd^Dr       , Ds          , Ds          , Ds          , Ds          , Ww^Bw\      , Ww          , Ds          , Ds          , Ds          , Ds          , Ds          , Ke          , Dd^Vdt      , Ke          , Ww          , Wo          , Rr          
Rr          , Xu          , Xu          , 1 Cud       , Ds          , Rd          , Rd          , Ds          , Ds          , Ds          , Dd^Do       , Ds          , Ds          , Hd          , Ds          , Ds          , Ds          , Md          , Ds          , Ww          , Ww          , Ds          , Ds          , Ds          , Ds          , Ds          , Ds          , Ke          , Ke          , Ke          , Ww          , Wo          , Rr          
Rr          , Rr          , Wo          , Xu          , Ds          , Ds          , Ds          , Rd          , Rd          , Ds          , Ds          , Gs^Ft       , Gs^Ft       , Ds          , Ds          , Dd^Do       , Ds          , Hd          , Ww          , Ww          , Ds          , Ds          , Ds          , Dd^Do       , Ds          , Ds          , Ds          , Ds          , Ds          , Gg          , Ww          , Wo          , Rr          
Rr          , Wo          , Ww          , Gg          , Ds          , Ds          , Ds          , Ds          , Ds          , Rd          , Rd          , Ds          , Gs^Ft       , Gs^Ft       , Ds          , Ds          , Hd          , Ds          , Ww^Bw\      , Ww          , Ds          , Ds          , Dd^Dr       , Ds          , Ds          , Gs^Ft       , Ds          , Dd^Do       , Ds          , Gg          , Ww          , Wo          , Rr          
Rr          , Wo          , Ww          , Gg          , Ds          , Dd^Do       , Ds          , Dd^Dr       , Ds          , Ds          , Ds          , Rd          , Rd          , Ds          , Ds          , Md          , Ds          , Ww          , Ww          , Ds          , Ds          , Ds          , Ds          , Ds          , Gs^Ft       , Gs^Ft       , Dd^Dr       , Ds          , Ds          , Gg          , Ww          , Wo          , Rr          
Rr          , Wo          , Ww          , Gg          , Ds          , Ds          , Ds          , Ds          , Ds          , Dd^Do       , Hd          , Ds          , Ds          , Rd          , Rd          , Ds          , Ww          , Ww          , Ds          , Ds          , Ds          , Dd^Do       , Ds          , Ds          , Gs^Ft       , Ds          , Ds          , Ds          , Ds          , Gg          , Ww          , Wo          , Rr          
Rr          , Wo          , Ww          , Gg          , Ds          , Ds          , Ds          , Ds          , Md          , Hd          , Ds          , Ds          , Ds          , Ds          , Ds          , Ww^Bw\      , Ww^Bw\      , Ww          , Ds          , Ds          , Ds          , Ds          , Dd^Dr       , Ds          , Md          , Hd          , Hd          , Ds          , Gs^Ft       , Gg          , Ww          , Wo          , Rr          
Rr          , Wo          , Ww          , Gg          , Gs^Ft       , Ds          , Gs^Ft       , Hd          , Md          , Ds          , Ds          , Ds          , Ds          , Dd^Do       , Ds          , Ww          , Ww          , Ww^Bw\      , Rd          , Ds          , Gs^Ft       , Ds          , Ds          , Ds          , Ds          , Md          , Hd          , Ds          , Ds          , Gg          , Ww          , Wo          , Rr          
Rr          , Wo          , Ww          , Gg          , Gs^Ft       , Gs^Ft       , Hd          , Hd          , Ds          , Ds          , Ds          , Dd^Do       , Ds          , Ds          , Ww          , Ww          , Ds          , Ds          , Ds          , Rd          , Rd          , Ds          , Ds          , Dd^Do       , Ds          , Hd          , Ds          , Ds          , Ds          , Gg          , Ww          , Wo          , Rr          
Rr          , Wo          , Ww          , Gg          , Ds          , Gs^Ft       , Ds          , Ds          , Gs^Ft       , Gs^Ft       , Ds          , Ds          , Ds          , Ds          , Ww^Bw\      , Ww          , Ds          , Ds          , Ds          , Gs^Ft       , Gs^Ft       , Rd          , Rd          , Ds          , Ds          , Ds          , Ds          , Dd^Do       , Ds          , Gg          , Ww          , Wo          , Rr          
Rr          , Wo          , Ww          , Gg          , Ds          , Gs^Ft       , Ds          , Ds          , Ds          , Ds          , Ds          , Ds          , Ds          , Ww          , Ww          , Ds          , Ds          , Ds          , Ds          , Gs^Ft       , Ds          , Ds          , Ds          , Rd          , Rd          , Ds          , Ds          , Ds          , Ds          , Gg          , Wo          , Wo          , Rr          
Rr          , Wo          , Ww          , Gg          , Ke          , Ds          , Ds          , Ds          , Ds          , Dd^Do       , Ds          , Ds          , Ww          , Ww          , Ds          , Ds          , Ds          , Dd^Do       , Ds          , Ds          , Hd          , Ds          , Dd^Do       , Ds          , Ds          , Rd          , Rd          , Ds          , Ds          , Xu          , Xu          , Rr          , Rr          
Rr          , Wo          , Ww          , Ke          , Dd^Vdt      , Ke          , Ds          , Ds          , Ds          , Ds          , Ds          , Ds          , Ww^Bw\      , Ww          , Ds          , Ds          , Ds          , Ds          , Md          , Hd          , Md          , Ds          , Ds          , Ds          , Ds          , Ds          , Ds          , Rd          , Cud         , 3 Cud       , Ds          , Xu          , Xu          
Rr          , Wo          , Ww          , Ke          , Ke          , Ke          , Ds          , Ds          , Ds          , Ds          , Ds          , Ww          , Ww          , Ds          , Ds          , Ds          , Ds          , Ds          , Ds          , Hd          , Hd          , Ds          , Ds          , Ds          , Dd^Do       , Ds          , Ds          , Ds          , 4 Cud       , Cud         , Ds          , Ds          , Ds          
Rr          , Wo          , Wo          , Ww          , Ww          , Gg          , Gg          , Ds          , Ds          , Ds          , Ww          , Ww          , Ds          , Ds          , Ds          , Dd^Do       , Ds          , Dd^Do       , Ds          , Ds          , Ds          , Dd          , Gs^Ft       , Ds          , Ds          , Ds          , Gg          , Xu          , Xu          , Ds          , Ds          , Ds          , Ds          
Rr          , Rr          , Rr          , Wo          , Wo          , Ww          , Ww          , Gg          , Gg          , Ds          , Ww^Bw\      , Ww          , Ds          , Ds          , Ds          , Ds          , Ds          , Ds          , Gs^Ft       , Gs^Ft       , Gs^Ft       , Gs^Ft       , Ds          , Ds          , Gg          , Gg          , Ww          , Wo          , Rr          , Xu          , Xu          , Ds          , Ds          
Rr          , Rr          , Rr          , Rr          , Rr          , Wo          , Wo          , Ww          , Ww          , Ww          , Ww          , Ds          , Ds          , Ds          , Ds          , Ds          , Ds          , Ds          , Ds          , Gs^Ft       , Ds          , Ds          , Gg          , Gg          , Ww          , Ww          , Wo          , Wo          , Rr          , Rr          , Rr          , Xu          , Xu          
Rr          , Rr          , Rr          , Rr          , Rr          , Rr          , Ch          , Wo          , Wo          , Ww          , Ww          , Gg          , Gg          , Ds          , Ds          , Ds          , Ke          , Ds          , Ds          , Ds          , Gg          , Gg          , Ww          , Ww          , Wo          , Wo          , Rr          , Rr          , Rr          , Rr          , Rr          , Rr          , Rr          
Rr          , Rr          , Rr          , Rr          , Rr          , Rr          , Ch          , Ch          , Ch          , Wo          , Wo          , Ww          , Ww          , Gg          , Gg          , Ke          , Dd^Vdt      , Ke          , Gg          , Gg          , Ww          , Ww          , Wo          , Wo          , Rr          , Rr          , Rr          , Rr          , Rr          , Rr          , Rr          , Rr          , Rr          
Rr          , Rr          , Rr          , Rr          , Rr          , Rr          , Rr          , 5 Ch        , Ch          , Ch          , Rr          , Wo          , Wo          , Ww          , Ww          , Ke          , Ke          , Ke          , Ww          , Ww          , Wo          , Wo          , Rr          , Rr          , Rr          , Rr          , Rr          , Rr          , Rr          , Rr          , Rr          , Rr          , Rr          
Rr          , Rr          , Rr          , Rr          , Rr          , Rr          , Rr          , Rr          , Rr          , Rr          , Rr          , Rr          , Rr          , Wo          , Wo          , Ww          , Ww          , Ww          , Wo          , Wo          , Rr          , Rr          , Rr          , Rr          , Rr          , Rr          , Rr          , Rr          , Rr          , Rr          , Rr          , Rr          , Rr          
Rr          , Rr          , Rr          , Rr          , Rr          , Rr          , Rr          , Rr          , Rr          , Rr          , Rr          , Rr          , Rr          , Rr          , Rr          , Wo          , Wo          , Wo          , Rr          , Rr          , Rr          , Rr          , Rr          , Rr          , Rr          , Rr          , Rr          , Rr          , Rr          , Rr          , Rr          , Rr          , Rr          
Rr          , Rr          , Rr          , Rr          , Rr          , Rr          , Rr          , Rr          , Rr          , Rr          , Rr          , Rr          , Rr          , Rr          , Rr          , Rr          , Rr          , Rr          , Rr          , Rr          , Rr          , Rr          , Rr          , Rr          , Rr          , Rr          , Rr          , Rr          , Rr          , Rr          , Rr          , Rr          , Rr          
Rr          , Rr          , Rr          , Rr          , Rr          , Rr          , Rr          , Rr          , Rr          , Rr          , Rr          , Rr          , Rr          , Rr          , Rr          , Rr          , Rr          , Rr          , Rr          , Rr          , Rr          , Rr          , Rr          , Rr          , Rr          , Rr          , Rr          , Rr          , Rr          , Rr          , Rr          , Rr          , Rr          
