border_size=1
usage=map

Gg          , Gg          , Gg          , Gg          , Gg          , Gg          , Gg          , Gg          , Gg          , Gg          , Gg          , Gg          , Gg          , Gg          , Gg          , Gg          , Gg          , Gg          , Gg          , Gg          , Gg          , Gg          , Gg          , Gg          , Gg          , Gg          , Gg          , Gg          , Gg          , Gg          , Gg          , Gg          , Gs          , Gg          , Gg          , Gg          
Gg          , Gg          , Gg          , Gg          , Gg          , Gg          , Gg          , Gg          , Gg          , Gg          , Gg          , Gg          , Gg          , Gg          , Gg          , Gg          , Gs          , Gg          , Gg          , Gg          , Gg          , Gg          , Gg          , Gg          , Gg          , Gg          , Gg          , Gg          , Gg          , Gg          , Gs          , Gg          , Gs          , Gg          , Gs          , Gs          
Rr          , Gg          , Gg          , Gg          , Gg          , Gg          , Gg          , Gg          , Gg          , Gg          , Gg          , Gg          , Gg          , Gg          , Gg          , Gg          , Gs          , Gg          , Gg          , Gg          , Hh          , Gg          , Gg          , Gg          , Gg          , Gg          , Gg          , Gg          , Gs          , Gs          , Gg          , Gg          , Gg          , Gg          , Gg          , Gg          
Gg          , Rr          , Rr          , Gg          , Gg          , Gg          , Gg          , Gg          , Gg          , Gg          , Gg          , Gg          , Gg          , Gg          , Gs          , Gs          , Gg          , Gs          , Gg          , Gg          , Gg          , Hh          , Hh          , Gg          , Hh          , Gg          , Gg          , Gs          , Gg          , Gg          , Gg          , Gg          , Gg          , Gg          , Gg          , Gg          
Gg          , Gg          , Gg          , Rr          , Rr          , Gg          , Gg          , Gg          , Gg          , Hh          , Gg          , Gs          , Gs          , Gg          , Gs          , Gg          , Gg          , Gs          , Gg          , Gg          , Gg          , Hh          , Hh          , Hh          , Hh          , Gg          , Gg          , Gg          , Gg          , Gg          , Gg          , Gg          , Gs          , Gg          , Gg          , Gg          
Gg          , Gg          , Gg          , Gg          , Hh          , Rr          , Rr          , Hh          , Hh          , Hh          , Gg          , Gg          , Gg          , Gg          , Gg          , Gs          , Gg          , Gs          , Gg          , Gg          , Gg          , Gg          , Hh          , Gg          , Hh          , Hh          , Hh          , Gg          , Gg          , Gg          , Gg          , Gg          , Gg          , Gg          , Hh          , Hh          
Gg          , Gg          , Gg          , Gg          , Hh          , Hh          , Hh          , Rr          , Rr          , Hh          , Hh          , Gg          , Gg          , Gg          , Gg          , Gg          , Gg          , Gg          , Gg          , Gs          , Gg          , Gg          , Gg          , Hh          , Hh          , Gg          , Gg          , Gg          , Gg          , Gg          , Gg          , Gs          , Gg          , Gg          , Gg          , Gg          
Gg          , Gg          , Gg          , Hh          , Gg          , Gg          , Gg          , Gg          , Gg          , Rr          , Rr          , Gg          , Gg          , Gg          , Gg          , Gg          , Gg          , Gg          , Gg          , Gg          , Gg          , Gg          , Gg          , Hh          , Gg          , Gg          , Gg          , Gg          , Gg          , Gg          , Gs          , Gs          , Gs          , Gg          , Gg          , Gg          
Gg          , Gg          , Gg          , Gg          , Hh          , Hh          , Hh          , Gg          , Gg          , Hh          , Gg          , Rr          , Rr          , Gg          , Gg          , Gg          , Gg          , Gg          , Gg          , Gg          , Gg          , Gg          , Gg          , Gg          , Gg          , Gg          , Gs          , Gg          , Gg          , Gs          , Gg          , Gs          , Gg          , Gs          , Gg          , Gg          
Gg          , Gg          , Gg          , Hh          , Gg          , Gg          , Gg          , Gg          , Gg          , Gg          , Gg          , Gg          , Gg          , Rr          , Rr          , Gg          , Gg          , Gg          , Gg          , Gs          , Gs          , Gg          , Gg          , Gg          , Gs          , Gs          , Gs          , Gg          , Gg          , Gg          , Gg          , Gg          , Gg          , Gg          , Gg          , Gg          
Gg          , Gg          , Gg          , Gg          , Gg          , Gg          , Gg          , Gg          , Gg          , Gg          , Gg          , Gg          , Gg          , Gg          , Gg          , Rr          , Rr          , Gg          , Gg          , Gg          , Gg          , Gs          , Gs          , Gs          , Gs          , Gs          , Gg          , Gg          , Gg          , Gg          , Gs          , Gg          , Gs          , Gs          , Gg          , Gg          
Gg          , Gg          , Gg          , Gg          , Gg          , Gg          , Gg          , Gg          , Gg          , Gg          , Gs          , Hh          , Hh          , Gg          , Gg          , Gg          , Gg          , Rr          , Rr          , Gg          , Gg          , Gg          , Gg          , Gs          , Gg          , Gs          , Gg          , Gg          , Gs          , Gs          , Gg          , Gg          , Gg          , Gg          , Gg          , Gg          
Gg          , Gg          , Gg          , Gg          , Gg          , Gg          , Gg          , Gg          , Gg          , Gs          , Gg          , Gg          , Hh          , Hh          , Gg          , Gg          , Gg          , Gg^Vh       , Gg          , Rr          , Rr          , Gg^Vh       , Gg          , Gg          , Gg          , Gg          , Gg          , Gg          , Gs          , Gg          , Gg          , Gg          , Gg          , Gg          , Gg          , Gg          
Gs          , Gs          , Gg          , Gg          , Gg          , Gs          , Gs          , Gs          , Gs          , Gs          , Gs          , Gs          , Gs          , Gg          , Gg          , Gg          , Gg          , Gg          , Rd          , Rd          , Gg          , Rr          , Rr          , Gg          , Gg          , Gg          , Gg          , Gg          , Gs          , Gg          , Gg          , Gg          , Ss          , Gg          , Ww          , Ww          
Gg          , Gg          , Gg          , Gg          , Gg          , Gg          , Gs          , Gg          , Gs          , Gg          , Gs          , Gs          , Gg          , Gg          , Gg          , Gs          , Gg          , Gg          , Rd          , Ch          , Ch          , Gg          , Gg^Vh       , Rr          , Rr          , Gg          , Gg          , Gg          , Gg          , Gs          , Gg          , Ss          , Ww          , Ww          , Ch          , Ch          
Gg          , Gg          , Gg          , Gg          , Gg          , Gg          , Gg          , Gg          , Gs          , Gs          , Gs          , Gg          , Hh          , Hh          , Gg          , Gg^Vh       , Gg          , Ch          , Rd          , Rd          , Ch          , Gg          , Rd          , Rd          , Gg          , Rr          , Rr          , Gg          , Gg          , Gg          , Ss          , Ss          , Ch          , Ch          , Ds          , Ds          
Gg          , Gg          , Gs          , Gg          , Gg          , Gg          , Gg          , Gs          , Gg          , Gg          , Gg          , Gs          , Gs          , Gg          , Gg          , Gg          , Gg          , 2 Kh        , Ch          , Rd          , Rd          , Gg          , Rd          , Gg          , Gg          , Gg          , Gg          , Rr          , Ww^Bw\      , Ww          , Ww          , Ch          , Ch          , Ds          , Gg          , Gg          
Gs          , Gs          , Gg          , Gg          , Gs          , Gg          , Gg          , Gg          , Gg          , Gg          , Gg          , Gg          , Gg          , Gg          , Gg          , Gg          , Gg          , Gg          , Gg          , Gg          , Gg          , Rd          , Ce          , Ce          , Ce          , Gg          , Gg          , Gg          , Ww          , Ww^Bw\      , Ww^Bw\      , Gg          , Gg          , Gg          , Rr          , Rr          
Gs          , Gs          , Gg          , Gg          , Gg          , Gg          , Gg          , Gg          , Gs          , Gs          , Gg          , Gg          , Gg          , Gg          , Gg          , Gs          , Gs          , Gg          , Gg          , Gg          , Ce          , Ce          , Re          , Ds          , Ds          , Ce          , Ce          , Gg          , Ww          , Ww          , Gg          , Rr          , Rr          , Rr          , Gg          , Gg          
Gs          , Gs          , Gs          , Gg          , Gg          , Gg          , Hh          , Gg          , Gg          , Gs          , Gg          , Hh          , Gg          , Gg          , Gg          , Gs          , Gg          , Gg          , Ce          , Ce          , Ds          , Ds          , Re          , Gs          , Gs          , Ds          , Ds          , Ce          , Ss          , Ch          , Ch          , Gg          , Rr          , Rr          , Rr          , Rd          
Gs          , Gs          , Gs          , Gg          , Gg          , Gg          , Gg          , Gg          , Gg          , Gg          , Gg          , Hh          , Hh          , Hh          , Gg          , Gg          , Ce          , Ce          , Ds          , Ds          , Gs          , Gs          , Re          , Re          , Ww          , Gs          , Gs          , Ds          , Ww          , Ch          , Ds          , Gg          , Rr          , Gg          , Rd          , Gg          
Gs          , Gs          , Gg          , Gg          , Hh          , Hh          , Hh          , Gg          , Gg          , Gg          , Hh          , Hh          , Hh          , Hh          , Gg          , Gg          , Ce          , Ds          , Gs          , Gs          , Re          , Re          , Re          , Gs^Vht      , Re          , Gs^Vht      , Gs          , Ss          , Ss          , Ch          , Ds          , Gg          , Rr          , Gg          , Gg^Vh       , Gg          
Gs          , Gs          , Gs          , Gg          , Gg          , Gg          , Gg          , Gg          , Gg          , Gg          , Hh          , Hh          , Hh          , Gg          , Gg          , Gg          , Ce          , Ds          , Gs          , Gs^Vht      , Ww          , Gs^Vht      , Ce          , Gs^Vht      , Re          , Gs^Vht      , Gs          , Ss          , Ss          , Ch          , Ds          , Gg          , Rr          , Rd          , Gg          , Gg          
Gs          , Gs          , Gs          , Gg          , Gs          , Gg          , Gs          , Gg          , Gs          , Gs          , Gg          , Hh          , Gg          , Gg          , Gg          , Gg          , Ce          , Ds          , Gs          , Gs          , Gs^Vht      , Gs^Vht      , Ce          , 1 Ke        , Gs^Vht      , Ww          , Gs          , Ww          , Ww          , Ch          , Ds          , Gg          , Rr          , Gg          , Gg          , Gg          
Gs          , Gs          , Hh          , Gg          , Gg          , Gg          , Gs          , Gg          , Gs          , Gg          , Gg          , Gg          , Gg          , Gg          , Gg          , Gg          , Ce          , Ds          , Gs          , Ww          , Re          , Re          , Gs^Vht      , Ce          , Re          , Re          , Gs          , Ss          , Ww          , Ch          , Ds          , Gg          , Rr          , Rd          , Gg          , Gg          
Hh          , Hh          , Hh          , Gg          , Gg          , Gg          , Gg          , Gs          , Gs          , Gg          , Gg          , Gg          , Gs          , Gs          , Gg          , Gg          , Ce          , Ds          , Gs          , Re          , Gs          , Gs^Vht      , Gs          , Ww          , Re          , Gs^Vht      , Gs          , Ss          , Ss          , Ch          , Ds          , Gg          , Rr          , Gg^Vh       , Gg          , Gg          
Hh          , Hh          , Gg          , Gg          , Gg          , Gg          , Gg          , Gg          , Gs          , Gg          , Gg          , Gg          , Gs          , Gs          , Ce          , Ce          , Ds          , Ds          , Gs          , Re          , Gs^Vht      , Ds          , Gs          , Gs^Vht      , Re          , Ww          , Gs          , Ss          , Ss          , Ch          , Ds          , Gg          , Rr          , Rd          , Rd          , Rd          
Gg          , Gg          , Gg          , Gg          , Gg          , Gg          , Gg          , Gg          , Hh          , Gg          , Gg          , Gg          , Ce          , Ce          , Ds          , Ds          , Ds          , Ds          , Gs^Vht      , Re          , Gs          , Gs^Vht      , Re          , Re          , Gs          , Gs^Vht      , Gs          , Ww          , Ss          , Ch          , Ds          , Gg          , Rr          , Gg          , Gg          , Gg          
Gg          , Gg          , Gg          , Gg          , Gg          , Gg          , Hh          , Hh          , Gg          , Hh          , Gg          , Gg          , Ce          , Ds          , Ds          , Ds          , Ds          , Gs          , Gs          , Ww          , Gs          , Ds          , Gs^Vht      , Ww          , Gs          , Gs          , Ss          , Ss          , Ss          , Ch          , Ch          , Gg          , Gg          , Gg          , Ww          , Ww          
Gg          , Gg          , Gg          , Gg          , Hh          , Gg          , Hh          , Hh          , Gg          , Gg          , Gg          , Ww          , Ww          , Ww          , Ww          , Ds          , Ds          , Ds          , Gs          , Gs          , Gs          , Gs          , Gs          , Gs          , Gs          , Gs          , Wwf         , Ww          , Ww          , Ch          , Ww          , Ww          , Ww          , Ww          , Ww          , Ww          
Gg          , Gg          , Gg          , Gg          , Gg          , Hh          , Hh          , Gg          , Gg          , Ww          , Ww          , Ww          , Wo          , Wo          , Wo          , Ww          , Ww          , Ww          , Ww          , Ww          , Ww          , Ww          , Ww          , Ww          , Ww          , Wwf         , Ww          , Ww          , Wo          , Ww          , Ww          , Ww          , Wo          , Wo          , Wo          , Wo          
Gg          , Gg          , Gg          , Gg          , Gg          , Hh          , Hh          , Gg          , Ww          , Ww          , Ww          , Ww          , Wo          , Wo          , Wo          , Wo          , Wo          , Wo          , Wo          , Ww          , Wo          , Ww          , Wo          , Ww          , Ww          , Wwf         , Wo          , Wo          , Wo          , Wo          , Wo          , Wo          , Wo          , Wo          , Wo          , Wo          
